
      	archiveswest
>Experimental films	lcsh
Advertising and Marketing	archiveswest
Agriculture	archiveswest
Airplanes	lcsh
Amateur Films	lcsh
American composers	lcsh
Anemia	lcsh
Anthropology	archiveswest
Archaeology	archiveswest
Archaeology	lcsh
Architecture	archiveswest
Artificial arms--Utah--History--Sources	lcsh
Artificial kidney--Utah--History--Sources	lcsh
Artists - Utah	lcsh
Artists--Utah	lcsh
Arts, Humanities, and Social Sciences	archiveswest
Arts, Humanities, and Social Sciences	umabroad
Authors, American	lcsh
Authors--Utah	lcsh
Automobiles, Racing--Speed records--United States--History--20th century.	lcsh
Automobiles, Racing--Speed records--Utah--Bonneville Salt Flats.	lcsh
Avalanches--Control--Utah	lcsh
Avalanches--Control	lcsh
Avalanches--Utah	lcsh
Avalanches	lcsh
Basketball--History	lcsh
Biathlon	lcsh
Bodybuilding.	lcsh
Book of Mormon--Authorship	lcsh
Book of Mormon--Criticism, interpretation, etc.	lcsh
Book of Mormon--Criticism, interpretation, etc	lcsh
Book of Mormon--Evidences, authority, etc	lcsh
California	archiveswest
Caving	lcsh
Children of immigrants--Utah--Interviews	lcsh
Children's radio programs	lcsh
Choreography	lcsh
Church of Jesus Christ of Latter-day Saints	lcsh
City and Town Life	archiveswest
Civic Activism	archiveswest
Civil Rights	archiveswest
Clubs and Societies	archiveswest
Coal mine accidents--Utah	lcsh
Colleges and Universities	archiveswest
Colorado River (Colo.-Mexico)	lcsh
Comedy	lcsh
Composers--Utah	lcsh
Computer graphics	lcsh
Computer science	lcsh
Computers	lcsh
Conductors	lcsh
Dance companies--Utah-History--Sources	lcsh
Dance--Utah-History--Sources	lcsh
Deep Springs College	lcsh
Democratic Party (Utah)	lcsh
Department of Ballet and Modern Dance--Utah-History	lcsh
Department of Ballet--Utah-History	lcsh
Department of Modern Dance--Utah-History	lcsh
Disc jockeys--Utah--Ogden--Sources	lcsh
Ecosystem health	lcsh
Editorial	lcsh
Education--United States--Sources	lcsh
Educational psychology	lcsh
Educational television stations--Utah--History--Sources	lcsh
Education	lcsh
Educators--Utah	lcsh
Election Day	lcsh
Elementary and Secondary Education	nwda
Elocution	lcsh
Employment agencies	lcsh
Endurance sports	lcsh
Engineers--Utah--Interviews	lcsh
Environmental Activism	archiveswest
Environmental Conditions	archiveswest
Environmentalism	lcsh
Equal rights amendments--United States--History--Sources	lcsh
Equal rights amendments--United States	lcsh
Ethnic Folkways library	lcsh
Exhibit	lcsh
Expeditions and Adventure	archiveswest
Exploration and discovery	lcsh
Eyes, Artificial--Utah--History--Sources	lcsh
Falconry	lcsh
Family--United States	lcsh
Feminism--United States	lcsh
Fine Arts	archiveswest
Fisheries and Wildlife	nwda
Flight simulators--Design and construction--History	lcsh
Food	lcsh
Football--History	lcsh
Forestry and Forestry Products	nwda
Freestyle Skiing	lcsh
Gas distribution--West (U.S.)--History--Sources	lcsh
Gender and culture	lcsh
Geology	lcsh
Gilgal Garden	lcsh
Girls' sports	lcsh
Heart, Artificial--Utah--History--Sources	lcsh
Heart, Mechanical--Utah--History--Sources	lcsh
Helicopter ambulances	lcsh
Hematology	lcsh
High school	lcsh
Hispanic American agricultural laborers	lcsh
Hispanic American families	lcsh
Hispanic American pioneers	lcsh
Hispanic Americans	lcsh
History, 20th Century--United States	lcsh
History	lcsh
Home & family	lcsh
Home and Family	archiveswest
Home economics--United States	lcsh
Home movies	lcsh
Homeless persons	lcsh
Horror	lcsh
Hotels	lcsh
Housewives--United States--Interviews	lcsh
Hydroelectric generators	lcsh
Hymn tunes	lcsh
Immigrants--Utah--Interviews	lcsh
Independent filmmakers	lcsh
Indians of North America--History--20th century--Interviews	lcsh
Indians of North America--Interviews	lcsh
Indians of North America--Social life and customs	lcsh
Indians of North America--West (U.S.)--Interviews	lcsh
International Women's Year (1977: Salt Lake City, Utah--Archives	lcsh
International Women's Year, 1975--Utah	lcsh
Internment of Japanese Americans, 1942-1945	lcsh
Italian Americans--Utah--Cultural assimilation	lcsh
Italian Americans--Utah--Interviews	lcsh
Italians--Utah--Interviews	lcsh
Japanese Americans--Utah--History--Sources	lcsh
Jews, American--Utah--Interviews	lcsh
Jews--Utah--Cultural assimilation	lcsh
Journalism	archiveswest
Journalism	umanarrow
Judaism	archiveswest
Labor Unions	archiveswest
Labor unions--United States--History--Sources	lcsh
Labor unions--United States--Songs and music	lcsh
Lectures and lecturing	lcsh
Literature	archiveswest
Material Types	archiveswest
Material Types	umabroad
Mayors	lcsh
Media and Communication	archiveswest
Medicine and Health	archiveswest
Medicine	lcsh
Memorial service	lcsh
Middle Eastern Americans	lcsh
Military	archiveswest
Missionaries	archiveswest
Modern dance	lcsh
Montage	lcsh
Mormon Church--History	lcsh
Mormon Church--Political activity	lcsh
Mormon Church	lcsh
Mormon women--United States--History--Sources	lcsh
Mormon women	lcsh
Mormonism (Church of Jesus Christ of Latter-day Saints)		archiveswest
Mormonism (Church of Jesus Christ of Latter-day Saints)	archiveswest
Mormonism (Church of Jesus Christ of Latter-day Saints	archiveswest
Mormonism	archiveswest
Motorcycle racing	lcsh
Mountaineering--West (U.S.)--History	lcsh
Mountaineers--West (U.S.)--Biography	lcsh
Moving Images	archiveswest
Moving Images	nwda
Moving Images	umanarrow
Music	archiveswest
Music	lcsh
Mysteries and conspiracies	lcsh
NCAA Basketball Tournament	lcsh
NCAA football	lcsh
National parks and reserves--United States	lcsh
National parks and reserves	lcsh
Native American life	lcsh
Native Americans 	lcsh
Native Americans	lcsh
Natural gas--West (U.S.)	lcsh
Novelty songs	lcsh
Nuclear fusion	lcsh
Ogden	nwda
Olympic Winter Games (15th : 1988 : Calgary, Alta.)	lcsh
Olympic Winter Games (19th : 2002 : Salt Lake City, Utah)	lcsh
Oral Histories	archiveswest
Oral history	lcsh
Orchestral music	lcsh
Painters - Utah	lcsh
Painting	lcsh
Parks And Playgrounds	archiveswest
Parks and Playgrounds	archiveswest
Patriotism	lcsh
Performing Arts	archiveswest
Performing Arts	umanarrow
Pharmacologists--Utah	lcsh
Pharmacology--Study and teaching--Utah	lcsh
Pharmacology	lcsh
Philosophy, American--20th century	lcsh
Philosophy	lcsh
Political Campaigns	archiveswest
Political campaigns	lcsh
Politics and culture--United States	lcsh
Polygamy--Personal narratives	lcsh
Presidents--United States--Election--1972	lcsh
Public Utilities	archiveswest
Public television--Utah--History--Sources	lcsh
Radio broadcasters	lcsh
Radio--History	lcsh
Radio	lcsh
Ranching	archiveswest
Ranching	lcsh
Rapids	lcsh
Restaurants	lcsh
Retail Trade	archiveswest
Revelation--Mormon Church	lcsh
Rivers--Recreational use 	lcsh
Rivers--Recreational use	lcsh
Rivers--West (U.S.)	lcsh
Rock climbing--West (U.S.)--History	lcsh
Rural conditions	lcsh
Salt Lake City	archiveswest
Science	archiveswest
Science	lcsh
Scottish Americans--Utah--Interviews	lcsh
Short stories	lcsh
Skateboarders	lcsh
Skateboarding.	lcsh
Ski acrobatics	lcsh
Ski resorts--Utah--Park City--History--Sources	lcsh
Ski resorts--Utah	lcsh
Skiing--Utah--History	lcsh
Skis and skiing--United States--History--Sources	lcsh
Skis and skiing--Utah--History--Sources	lcsh
Skis and skiing--Utah--Park City--History--Sources	lcsh
Smokejumping	lcsh
Snowboarders	lcsh
Snowboarding.	lcsh
Snowboarding	lcsh
Soccer	lcsh
Social Classes	archiveswest
Social Life and Customs	archiveswest
Social Life and Customs	umabroad
Sound Recordings	archiveswest
Sound Recordings	umanarrow
Sports and Recreation>	archiveswest
Sports and Recreation	archiveswest
Sports and Recreation	nwda
Sports and Recreation	umanarrow
Sports	lcsh
Strikes and lockouts--Coal mining--Utah	lcsh
Student Life	nwda
Surfing.	lcsh
Technology	archiveswest
Technology	lcsh
Television broadcasting of news--Utah	lcsh
Television news	lcsh
Television--History	lcsh
Textbooks.	lcsh
Theater--Utah	lcsh
Theatre	lcsh
Theory (Philosophy)	lcsh
Tourism	lcsh
United States Ski Team	lcsh
University of Utah--Faculty--Biography	lcsh
Utah--History	lcsh
Utah	archiveswest
Utah	lcsh
Utah	nwda
Veterans	lcsh
Viola	lcsh
Water and Water Rights	archiveswest
West (U.S.)--History--20th century	lcsh
Wildlife management -- Utah	lcsh
Winter Olympics	lcsh
Women and religion	lcsh
Women in church work--Mormon Church--History--Sources	lcsh
Women in politics--Utah--History--Sources	lcsh
Women legislators--Utah--History--Sources	lcsh
Women's rights--United States	lcsh
Women	lcsh
World War II	lcsh
Yodeling	lcsh
Zuni Indians--Claims	lcsh
Zuni Indians--History	lcsh
Zuni Indians--Land tenure	lcsh
